Wo, Wo, Wo, Wo, Wo, Wo, Wo, Wo, Wo, Wo, Wo, Wo, Wo, Wo, Wo, Wo, Wo, Wo, Wo, Wo, Wo, Wo, Wo, Wo, Wot, Wo, Wo^Edb, Wo^Edb, Wo^Edb, Wwr, Wwr, Wwr, Wwrt, Xue, Xue, Xue, Xue, Xue, Wwr, Wwr, Wwr, Wwr, Wwr, Wo, Wo^Edb, Wo^Edb, Wo^Edb, Wo, Wo, Wo, Wo, Wo, Wo, Wo, Wo, Wo, Wo, Wo, Wo, Wo, Wo, Wot, Wo, Wo, Wo, Wo, Wo, Wo, Wo, Wo, Wo, Wo
Wo, Wo, Wo, Wo, Wo, Wo, Wot, Wo, Wo, Wo, Wot, Wot, Ds^Esd, Wot, Wot, Wo, Wo, Wo, Wot, Wot, Wot, Wo, Wot, Wot, Wot, Wot, Wot^Edt, Wo^Edt, Wo^Edt, Wot, Wot, Wwr, Wwr, Xu, Xue, Xue, Xu, Xue, Wwr, Wwr, Wot, Wot, Wot, Wot, Wot, Wo^Edt, Wot^Edt, Wo^Edt, Wot, Wo, Wo, Wo, Wot, Wo, Wot, Wo, Wot, Wo, Wot, Wo, Wot, Wo, Wot, Wo, Wot, Wot, Wot, Wo, Wo, Wo, Wo, Wo
Wo, Wo, Wo, Wo, Wot, Wot, Ds, Wot, Wot, Wot, Ds, Ds, Dd^Ftd, Ds, Ds, Wot, Wot, Wot, Dd, Dd^Esd, Dd, Wot, Dd, Dd^Esd, Dd, Wot, Wot^Edt, Wot^Edb, Wot^Edt, Wot, Wot, Wot, Wot, Wwr, Wwr, Xue, Xu, Wwr, Wot, Wot, Wot, Wot, Wot, Wot, Wot, Wot^Edt, Wot^Edt, Wot, Wot, Wot, Wot, Wot, Wot, Wot, Dd, Wot, Wot, Wot, Wot, Wot, Dd, Wot, Wot, Wot, Dd, Wot, Dd, Wot, Wot, Wo, Wo, Wo
Wo, Wo, Wot, Wot, Ds^Esd, Ds, Gg, Ds, Ds, Ds, Gg, Gg, Gg, Gg, Gg, Ds, Ds, Dd, Gg, Dd^Ftd, Gg, Dd, Gg, Gg, Gg, Dd^Ftd, Dd^Ftd, Wot^Edt, Wot^Edt, Wot, Wot, Wot, Wot, Wot, Xu, Xue, Wot, Wot, Wot, Wot, Wot, Wot, Wot, Wot, Dd^Edt, Wot^Edt, Ds^Edt, Dd^Edt, Ds, Wwt, Dd, Wwt, Ds, Dd, Dd^Ftd, Dd, Ds, Wot, Ds, Dd, Gg, Dd, Dd, Dd, Gg, Dd, Dd^Ftd, Dd, Dd, Wot, Wot, Wo
Wo, Wo, Wot, Wot, Ds, Dd^Ftd, Gg, Gg, Gg, Dd^Ftd, Gg, Gs^Ftp, Gg, Gg, Gg, Gg, Gg, Gg, Gg, Gg, Gg, Gg, Gs^Ft, Gg, Gg, Gg, Gg, Ds^Edt, Ds^Edt, Wot, Wot, Wot, Wot, Wot, Wot, Xu, Xu, Wot, Wot, Wot, Wot, Wot, Dd^Ftd, Dd^Ftd, Gg, Ds^Edt, Gg, Dd^Ftd, Gg, Ds, Dd^Ftd, Ds, Gg, Gg, Gg, Gg, Gg, Ds, Gg, Gg, Gg, Dd^Ftd, Gg, Gg, Gs^Ft, Gg, Gg, Dd, Dd^Ftd, Dd, Wot, Wot
Wo, Wo, Wot, Wot, Dd^Ftd, Gs, Gg, Gs^Ftp, Gs^Ft, Gg, Gg, Gg, Gg, Gd^Fts, Gg, Gd^Fts, Gg, Gs^Vc, Gs, Md, Gg^Es, Gg, Gg, Gg, Gs, Gg, Gg, Gs^Ftp, Gg, Ds, Ds, Wot^Edt, Wot, Wot, Xue, Xu, Wot, Wot, Wwrt, Wot, Ds, Ds, Gg, Gg, Gg, Gs^Ftp, Gg, Gs, Gg, Gg, Gg, Gg, Gg, Gg, Md, Gg, Gs^Vc, Gg, Gg, Gg, Gg, Gg, Gg, Gg, Gg, Gg, Gs^Ftp, Gg, Gg, Dd, Wot, Wot
Wo, Wo, Wot, Wot, Ds, Gs, Dd^Ftd, Gg, Gg, Gs^Vc, Gg, Gg, Ds, Gg, Gg, Gg, Gg, Gg, Gg, Gg, Gs, Gg, Gg, Gs^Ft, Gg, Gg, Gg, Gg, Gg, Gg, Gs, Ds, Ds^Esd, Wot, Wot, Xue, Xue, Wwr, Ds^Esd, Ds, Gg, Gd, Gg, Gg, Gg, Gg, Gg, Gg, Gg, Gs^Ft, Gg, Gg, Gs^Ft, Gg, Gg, Gg^Es, Ds, Gg, Gg, Gd^Fts, Gg, Gg, Gg, Gs, Gs^Vc, Gg, Gg, Gg, Dd, Dd, Wot, Wot
Wo, Wo, Wot, Wot, Ds, Ds, Gg, Gg, Gg, Gg, Ds, Ds, Gd^Fts, Ds, Ds, Gg, Gg, Gg, Gs^Ft, Gg, Gs, Gd, Gg, Gg, Gg, Gg, Cdr^Edt, Dd^Esd, Cdr^Edb, Gg, Gd, Dd^Ftd, Ds^Esd, Wwr, Xue, Xu, Wot, Wwrt, Ds^Esd, Dd^Ftd, Gg, Gg, Gg, Gg, Cdr^Edb, Dd^Esd, Cdr^Edb, Gg, Gg, Gg, Gg, Gg, Gs, Gg^Em, Gg, Gg, Ds, Dd^Ftd, Ds, Gg, Gg, Gs^Ft, Gs, Gg, Gg, Gg, Gg, Dd, Wot, Dd, Wot, Wot
Wo, Wo, Wot, Wot, Dd^Ftd, Gs, Gd^Fts, Gd^Fts, Gg, Ds, Ds, Gd, Gs, Gs, Ds, Ds^Esd, Gg^Edp, Gg^Em, Gg, Gg, Gg, Gd^Fts, Gg, Gg, Ds, Dd^Ftd, Cd^Edt, 2 Kdr, Cdr^Edb, Dd^Vdt, Dd^Ecf, Ds, Ds^Esd, Wwr, Wot, Xue, Wot, Wwr, Dd^Esd, Dd, Dd, Gg, Dd^Ecf, Dd^Vdt, Cdr^Edb, 3 Kdr, Cd^Edb, Dd^Ftd, Ds, Gg, Gd^Fts, Gg, Gs, Gg, Gg, Gg, Dd, Ds, Gs, Gg, Gg, Gg, Gg, Gg, Gd^Fts, Gd^Fts, Gg, Dd, Dd, Wot, Wot, Wot
Wo, Wo, Wot, Ds^Esd, Ds, Gs, Gg, Gg, Gg^Es, Gg, Md, Ds, Ds, Ds, Gg, Gg, Gg, Gd^Fts, Gd^Fts, Gs, Gg, Gg, Gg, Gg, Gg, Gs, Gs, Cdr^Edb, Gg^Esd, Dd^Es, Dd^Ftd, Dd^Es, Wot, Wot, Xue, Xu, Xu, Wot, Wot, Dd, Dd, Dd^Es, Dd^Esd, Dd^Es, Gg, Cdr^Edb, Gg, Gg, Gg, Gg, Gg, Gg, Gg, Gd^Fts, Gg, Gg, Gg, Gg, Gg, Gg, Gg, Gg, Md, Gs, Gg, Gg, Ds, Gg, Dd, Wot, Wot, Wot
Wo, Wo, Wot, Wot, Wot, Ds, Gg, Gg, Gg^Es, Md, Gg^Es, Gg, Gg, Gg, Gg, Gg, Gg, Gg, Gd, Gd^Fts, Gg, Gs^Ft, Gg, Gg, Gs^Ftp, Gg, Gg, Gg, Dd^Ftd, Dd, Wot, Wot, Xu, Xue, Ww, Ww^Vm, Ww, Xue, Xu, Wot, Wot, Dd^Ftd, Dd, Gg^Esd, Gg, Gg, Gg, Gg, Gs^Ftp, Gg, Gg, Gg, Gs^Ft, Gs, Gg, Gd^Fts, Gd^Fts, Gg, Gg, Gs^Ft, Gg, Gg, Gg, Md, Gg, Gg, Gg, Gg, Dd, Wot, Wot, Wot
Wo, Wo, Wot, Dd^Ftd, Dd^Ftd, Ds, Gg, Gg, Gg, Gg, Gg, Gg, Gs^Ft, Gg, Gg, Gd^Fts, Dd^Ftd, Gg, Gg, Gg, Gg, Gg, Gg, Gg, Gg, Gg, Dd^Ftd, Dd, Wot, Wot, Xue, Xue, Wwrt, Ww, Cm, Ww, Cm, Ww, Wwr, Xue, Xue, Wot, Wot, Dd^Ftd, Dd, Gg, Gs, Gs, Gg, Gg, Gg, Gg, Dd^Ftd, Gg, Gg, Gg, Gd, Gg, Gg, Gg, Gg, Gg, Gg, Gg, Gg, Gd^Fts, Gg, Gg, Gg, Dd, Wot, Wot
Wo, Wo, Wot, Ds^Esd, Ds, Dd^Ftd, Gg, Gg, Gs^Vc, Gll, Gg, Gg, Gg, Gg, Gg, Gg, Ds, Gg, Dd^Ftd, Gg, Ds, Dd^Ftd, Ds, Gg, Ds, Ds, Wot, Wot, Xue, Xu, Wo, Wo, Wot, Wot, Cm, Km, Cm, Wot, Wot, Wo, Wo, Xu, Xue, Wot, Wot, Dd^Ftd, Dd, Gd, Ds, Gg, Gg, Gg, Dd, Gg, Gg, Gg, Gg, Gd^Fts, Gg, Gg, Gg, Gd^Fts, Gg, Gg, Gg, Gg, Gg, Gg, Dd, Dd, Wot, Wot
Wo, Wo, Wo, Wot, Ds^Esd, Gs, Gg, Gg, Gg, Gg, Gd^Fts, Gg, Gg, Gg, Dd^Ftd, Ds, Ds^Esd, Ds^Esd, Ds^Esd, Ds, Wot, Ds, Ds^Esd, Ds, Wot, Wot, Xue, Xue, Wo, Wo, Wo, Wo, Wot, Wwt, Ds, Cm, Ds, Wwt, Wot, Wo, Wo, Wo, Wo, Xu, Xue, Wot, Wot, Ds, Wot, Ds, Ds, Ds, Wot, Dd, Ds, Ds, Ds, Gg, Gg, Gg, Gg, Gs^Ft, Gs^Vc, Gll, Gg, Gs^Ft, Gg, Gg, Dd, Wot, Wot, Wot
Wo, Wo, Wo, Wot, Wot, Ds^Esd, Ds, Gg, Gg, Gg, Gg, Gg, Gg, Gg, Ds, Ds, Wwt, Wwt, Wot, Wot, Wo, Wot, Wot, Wot, Xue, Xu, Wwrt, Wo, Wot, Wot, Wot, Wo, Wot^Bw/, Wot^Bw/, Wwr, Wo, Wwrt, Wot^Bw\, Wot^Bw\, Wo, Wot, Wot, Wot, Wo, Wwrt, Xue, Xue, Wot, Wo, Wot, Wot, Wot, Wo, Wot, Wot, Wot, Wot, Ds, Ds, Dd^Ftd, Gs, Gs, Gs, Gg, Gg, Gg, Gg, Dd, Wot, Wot, Wot, Wot
Wo, Wo, Wo, Wot, Wot, Wot, Ds, Gg, Dd^Ftd, Gg, Gd^Fts, Gd^Fts, Gd^Fts, Gd^Fts, Ds^Esd, Wwr, Wwt, Wot, Wo, Wo, Wot, Wo, Wo, Wo, Wot, Wot, Wot, Wot, Wot, Wot, Wot^Bw/, Wot^Bw/, Wot, Wwrt, Wot, Wo, Wot, Wwrt, Wot, Wot^Bw\, Wot^Bw\, Wot, Wot, Wot, Wot, Wot, Wot, Xu, Wot, Wo, Wo, Wo, Wot, Wo, Wo, Wo, Wo, Wwt, Wwr, Dd^Esd, Gd^Fts, Gs, Gd^Fts, Gd^Fts, Gd^Fts, Gg, Gg, Dd, Dd, Wot, Wot, Wot
Wo, Wo, Wo, Wo, Wot, Wot, Ds, Ds, Gg, Gd^Fts, Gd, Gg, Gd^Fts, Ds, Ds^Esd, Wwrt, Wwt, Wo, Wot, Wot, Ds^Esd, Wot, Wot, Wot, Ds^Esd, Wot, Ds^Esd, Dd^Esd, Dd^Esd, Wot^Bw/, Wot, Wot, Wot, Wot, Ds, Ds^Eb, Ds, Wot, Wot, Wot, Ds^Esd, Dd^Esd, Dd^Esd, Wot, Ds^Esd, Wot, Wot, Wot, Wot, Wot, Wot, Wot, Ds^Esd, Wot, Wot, Wot, Wot, Wwt, Wwrt, Dd^Esd, Ds^Esd, Gd^Fts, Gs, Gs, Gg, Gd^Fts, Dd, Dd, Wot, Wot, Wot, Wot
Wo, Wo, Wot, Wot, Ds^Esd, Ds^Esd, Dd^Ftd, Gs^Vc, Gg, Gg, Gg, Gg, Gg, Gd^Fts, Gg, Ds, Ds, Wwt, Ds^Esd, Ds^Esd, Dd^Ftd, Ds^Esd, Ds^Esd, Dd^Ftd, Ds^Esd, Ds^Esd, Dd^Edp, Ds^Esd, Ds^Esd, Ds^Esd, Dd^Ftd, Ds^Esd, Ds^Esd, Ds^Esd, Wo, Wo, Wo, Ds, Ds^Esd, Ds, Dd^Ftd, Ds^Esd, Ds^Edp, Ds, Gs, Ds, Ds, Wot, Ds, Ds^Esd, Dd, Ds, Dd^Esd, Ds^Esd, Ds^Esd, Dd^Esd, Dd, Wwt, Dd, Dd^Esd, Gg, Gd^Fts, Gg, Gg, Gs, Dd^Ftd, Dd, Dd, Wot, Wot, Wot, Wot
Wo, Wo, Wo, Wot, Wot, Ds, Gg, Gg, Gg, Gs^Ft, Gs, Dd, Gg, Gd^Fts, Gg, Gg, Gg, Mdd, Mdd, Rd, Rd, Rd^Edp, Dd^Ftd, Ds^Edp, Gd^Esd, Dd^Edpp, Dd, Gd, Gs^Esd, Gg, Ds^Esd, Dd^Ftd, Mdd, Ds^Esd, Dd^Vda, Dd^Ftd, Dd^Vdr, Ds^Esd, Mdd, Ds^Esd, Dd, Gd^Edt, Gd^Edt, Gd, Gs, Dd^Ftd, Gs, Ds^Esd, Gs^Ft, Gd, Gd^Fts, Dd^Edp, Dd^Dr, Rd^Edp, Rd^Edp, Rd, Mdd, Mdd, Dd, Gg, Ds, Gg, Gd^Fts, Gll, Gs^Vc, Gg, Dd, Dd^Ftd, Wot, Wot, Wot, Wot
Wo, Wo, Wo, Wo, Wot, Ds, Gg, Gg, Md, Gg, Gg, Gg, Ds, Ds, Ds, Ds, Gg, Dd, Rd^Edp, Mdd, Mdd, Rd^Edp, Rd, Gs^Edp, Dd^Edp, Ds^Esd, Ds^Edp, Ds^Esd, Dd, Dd^Ftd, Ds^Esd, Mm, Dd^Vdr, Dd^Vdr, Dd^Ftd, Ds, Dd^Ftd, Dd^Vdr, Dd^Vdr, Ds^Edp, Ds^Edp, Ds^Edt, Gs, Dd^Ftd, Gd^Esd, Gs, Ds^Edp, Ds, Dd^Ftd, Ds, Gd^Esd, Rd^Edp, Rd^Edp, Rd^Edp, Mdd, Mdd, Rd^Edp, Rd^Edp, Dd^Edp, Ds^Esd, Ds, Gd^Fts, Gg, Gs, Gg, Gs, Dd, Dd, Wot, Wot, Wot, Wot
Wo, Wo, Wot, Wot, Ds, Ds, Gs^Ft, Gg, Gg^Es, Md, Md, Gg, Ds^Esd, Dd^Ftd, Ds, Gd^Fts, Dd^Dc, Dd^Edp, Mdd^Dr, Dd^Vdr, Rd^Edp, Mdd, Mdd, Rd, Gd^Esd, Gs^Dr, Ds^Esd, Dd^Edp, Ds, Ds, Dd^Ftd, Dd^Ftd, Dd^Vdr, Ds, Dd^Ftd, Dd^Do, Dd^Ftd, Ds, Dd^Vda, Dd^Ftd, Dd^Ftd, Ds, Gs, Gs, Gs^Esd, Gd^Edp, Ds^Dr, Ds^Edp, Gs, Gs, Ds^Edp, Rd, Mdd, Mdd, Rd^Edp, Dd^Vdr, Mdd, Dd^Edp, Dd^Dc, Ds^Esd, Dd^Ftd, Ds, Md, Gg, Gg, Gg, Dd, Wwt, Wwt, Wot, Wot, Wot
Wo, Wo, Wot, Wot, Ds, Gs^Ftp, Gg, Gs, Gg, Gg^Es, Gg, Ds, Dd^Do, Ds, Gg, Ds, Ds^Esd, Dd^Esd, Rd^Edp, Rd^Edp, Mdd, Mdd, Rd^Edp, Rd, Gs, Dd^Ftd, Gd, Dd^Ftd, Ds, Gs^Ft, Ds^Edp, Ds^Edp, Mdd, Dd^Vdr, Dd^Vdr, Ds, Dd^Vda, Dd^Vda, Mdd, Dd, Ds, Gs^Ft, Dd^Ftd, Ds^Edp, Ds, Ds^Esd, Ds^Esd, Ds^Esd, Dd^Ftd, Gs^Edp, Gs^Edp, Rd^Edp, Rd^Edp, Mdd, Mdd, Rd^Edp, Dd^Ftd, Dd^Edb, Ds^Esd, Dd^Do, Ds, Ds^Esd, Gg^Es, Md, Md, Gg, Gg, Dd, Dd, Wot, Wot, Wot
Wo, Wo, Wot, Ds^Esd, Dd, Gg, Dd, Dd, Dd, Gg, Dd, Dd^Ftd, Ds, Ds^Esd, Gg, Gg, Rd, Rd, Mdd, Mdd, Rd^Edp, Rd, Ds^Esd, Gs^Edp, Dd^Ftd, Gs, Gd, Ds^Esd, Dd^Ftd, Dd, Dd^Esd, Ds^Esd, Ds^Esd, Ds, Wo, Dd^Ftd, Wo, Ds^Esd, Ds, Dd, Ds^Edp, Ds, Ds^Esd, Ds, Dd^Ftd, Dd^Ftd, Ds, Gs, Dd^Ftd, Ds, Ds^Esd, Ds^Esd, Dd^Ftd, Rd^Edp, Rd^Edp, Mdd, Mdd, Rd, Gg, Ds, Gs^Ft, Gs, Gs, Gg^Es, Gs, Gg, Gg, Dd^Ftd, Ds, Ds^Esd, Wot, Wot
Wo, Wo, Wot, Dd^Ftd, Gs, Dd, Gg, Gs, Gg, Dd, Gd^Fts, Gg, Gg, Ds, Gg, Gg, Ds, Mdd, Ds^Esd, Rd^Edp, Ds^Esd, Dd^Ftd, Ds^Esd, Ds^Esd, Ds^Esd, Dd^Ftd, Ds^Esd, Ds, Ds^Esd, Dd, Dd^Edp, Dd^Esd, Wot, Ds^Esd, Ds^Esd, Wo, Ds^Esd, Ds, Wot, Wot, Wot, Ds^Esd, Dd, Dd^Ftd, Ds^Esd, Ds^Esd, Wot, Ds, Wwrt, Ds, Wot, Ds^Esd, Dd^Ftd, Ds^Esd, Dd^Esd, Dd, Dd, Mdd, Ds, Gg, Gg, Gg, Gs, Gg, Gd^Fts, Gll, Gs^Vc, Gg, Ds, Wwt, Wot, Wot
Wo, Wo, Wot, Ds, Ds, Gg, Gg, Gs^Vc, Gg, Gg, Gs^Ft, Gg, Gd^Fts, Gg, Dd^Esd, Dd, Wwt, Dd^Esd, Wot, Ds^Esd, Wot, Dd^Ftd, Wot, Wot, Wot, Wot, Wot, Wot, Wot, Dd^Esd, Wot^Bw\, Wot, Wot, Wot, Wot, Ds^Eb, Wot, Wot, Wot, Wot, Wot^Bw/, Wot^Bw/, Wot, Dd, Wot, Wot, Wot, Wot, Wot, Wot, Wot, Wot, Wot, Wot, Wo, Wot, Wot, Dd^Esd, Wwt, Ds^Esd, Ds, Gg, Gg, Gg, Gd^Fts, Gs, Gg, Gg, Ds, Wot, Wot, Wot
Wo, Wo, Wot, Wot, Ds, Gg, Gd^Fts, Gg, Gd^Fts, Gd^Fts, Gg, Gd^Fts, Gg, Dd^Ftd, Dd^Esd, Wwt, Wwrt, Wot, Wo, Wot, Wo, Wot, Wo, Wot, Xu, Wot, Wwr, Wot, Wot, Wot, Wot, Wwrt^Bw\, Wwrt^Bw\, Wwrt, Wwrt, Wo, Wwrt, Wwrt, Wwrt^Bw/, Wwrt^Bw/, Wot, Wot, Wot, Wot, Wwrt, Wot, Xue, Xu, Wo, Wot, Wo, Wot, Wo, Wo, Wo, Wo, Wo, Wwt, Wwt, Ds^Esd, Dd^Ftd, Gg, Gd^Fts, Gg, Gs, Gd^Fts, Gd^Fts, Dd^Ftd, Gs, Ds, Wot, Wot
Wo, Wo, Wot, Wot, Ds, Gd^Fts, Gg, Gd^Fts, Gg, Gg, Gll, Gg, Gd^Fts, Gg, Dd^Esd, Wwt, Wwt, Wo, Wot, Wo, Wot, Wo, Wot, Wo, Wot, Xue, Xu, Wo, Wo, Wot, Wo, Wo, Wot, Wwrt^Bw\, Ds, Wo, Ds, Wwrt^Bw/, Wot, Wo, Wo, Wot, Wo, Wo, Xue, Xue, Wot, Wot, Wot, Wo, Wot, Wo, Wot, Wot, Wot, Wot, Wot, Wwrt, Wwt, Ds^Esd, Gg, Gd^Fts, Gg, Gd^Fts, Gd^Fts, Gd^Fts, Gg, Gg, Gs, Ds, Wot, Wot
Wo, Wo, Wot, Wot, Ds, Gd^Fts, Gg, Gg, Gd, Gd^Fts, Gs, Gg, Gg^Es, Gg, Gg, Dd, Dd, Wot, Dd^Esd, Wot, Wot, Wot, Dd^Esd, Wot, Wot, Wot, Wot, Xue, Xu, Wo, Wo, Wo, Wot, Wwt, Cme, Cme, Cme, Wwt, Wot, Wo, Wo, Wo, Xu, Xue, Wot, Wot, Wot, Wot, Dd^Ftd, Wot, Wot, Wot, Ds^Esd, Wot, Wot, Wot, Ds^Esd, Wwt, Ds, Ds, Gg, Gg, Gll, Gs, Gd, Gg, Gg, Gd^Fts, Gs, Ds, Wot, Wot
Wo, Wo, Wot, Wot, Ds, Gd^Fts, Gg, Gg, Gg, Gs^Vc, Gg, Gg, Gg, Gg, Gg, Gg, Gs^Ft, Dd, Gg, Dd, Dd, Dd^Ftd, Gs, Dd, Dd, Wot, Wot, Wot, Wot, Xue, Xu, Wo, Wwrt, Wot, Cme, Km, Cme, Wot, Wwr, Wo, Xue, Xue, Wot, Wot, Wot, Wot, Ds, Ds, Ds, Ds, Dd^Ftd, Ds, Gg, Ds, Ds, Ds, Dd^Ftd, Ds, Gg, Gg, Gg, Gg, Gg, Gs^Vc, Gs, Gg, Gg, Gg, Gs, Dd^Ftd, Wot, Wot
Wo, Wo, Wot, Ds, Gs, Gg, Gg, Gg, Gg, Gg, Gg, Gs, Gs^Ft, Gg, Gg, Gg, Gg, Gg, Gg, Gg, Dd^Ftd, Gg, Gg, Gs, Gs, Dd, Dd, Wot, Wot, Wot, Wot, Xue, Xue, Ww, Ww, Ww, Ww, Ww, Xue, Xu, Wot, Wot, Wot, Wot, Ds, Dd^Ftd, Gs, Dd^Ftd, Gs, Gs, Gg, Gg, Gs, Gg, Dd^Ftd, Gg, Gg, Gg, Gd^Fts, Gg, Gs, Gg, Gs, Gg, Gs, Gs, Gs^Ft, Gg, Gs, Ds, Wot, Wot
Wo, Wo, Ds^Esd, Ds, Gs, Gg, Gg, Md, Md, Gg, Gg, Gg, Gs, Gg, Gg, Gg^Es, Gg, Gg, Gs^Ft, Gs, Gs, Gg, Gg, Gg^Es, Gg, Gs^Ft, Gs^Ft, Dd, Dd, Wot, Wot, Wot, Wot, Xue, Xue, Ww^Vm, Xu, Xue, Wot, Wot, Wot, Wot, Dd, Ds, Gs, Gs, Gg, Gs, Gs, Gg, Gg, Gg, Gg, Gg, Gg, Gg, Gg, Gd^Fts, Gg, Gg, Gg, Gs^Ft, Gg, Gg, Gg, Gg, Gg, Gg, Gs, Dd^Ftd, Wot, Wot
Wo, Wo, Ds, Dd^Ftd, Gd^Fts, Gg, Gg, Gg^Es, Gg, Gg^Es, Gs^Ft, Gg, Gs, Gg, Gd^Fts, Gg, Gs, Gg, Gg, Gg^Em, Gg, Gg, Gg, Gs, Gg, Gg, Gg, Gs, Gs, Dd^Ftd, Dd, Wot, Wot, Wot, Wot, Xu, Wot, Wot, Wot, Wot, Dd, Dd, Gs^Ft, Gs^Ft, Gg, Gg, Gg, Gs^Ftp, Gg, Gs, Gs, Gg, Gs^Ft, Gg, Gg, Gg, Gd, Gg, Gg^Es, Gg, Gg, Gg, Gg, Gg, Md, Gg, Gg, Gg, Gs, Ds, Wot, Wot
Wo, Wo, Wot, Ds, Gs, Gg, Gd^Fts, Gs, Gg, Gg, Gg, Gg, Gg, Gd^Fts, Gg, Gs, Gg, Gs, Gg, Gg, Gg, Gs^Ftp, Gg, Gg, Gg, Gg, Gg, Gg, Gg, Gs, Gg, Dd, Ds^Esd, Wot, Wot, Xue, Xue, Wot, Dd^Esd, Dd, Ds^Esd, Ds^Esd, Gg, Gg, Gg, Gg, Gg, Gg, Gg, Gg, Gg, Gs^Ft, Gg^Em, Gs^Ft, Gg, Gg, Gs, Gd^Fts, Gd^Fts, Gs, Ds, Gs, Gg, Md, Gg^Es, Gg, Gg, Gg, Ds, Ds, Wot, Wot
Wo, Wo, Wot, Ds, Gs^Ft, Gg, Gg, Gg, Gs^Ft, Gg, Gs, Gg, Gd^Fts, Gg, Gs, Gg, Gs^Ft, Gg, Gg, Ds, Ds, Gg, Ds, Ds, Gg, Gg, Cdr^Edb, Dd^Esd, Cdr^Edb, Gg, Gg, Gs^Ft, Ds^Esd, Wot, Xue, Xue, Wot, Wwr, Dd^Esd, Dd^Ftd, Gg, Gg, Gg, Gg, Cdr^Edb, Dd^Esd, Cdr^Edb, Gg, Gg, Gg, Gg, Gg, Gd^Fts, Gg, Gg, Gs^Es, Gg, Gg, Gs, Ds, Gd^Fetd, Ds, Gg, Gg, Gg, Gg, Gg, Gs^Ft, Ds, Wot, Wot, Wot
Wo, Wo, Wot, Ds^Esd, Gs, Gg, Gg, Gg, Gs, Gg, Gg, Gd^Fts, Gg, Gg, Gg, Gg, Gg, Gg, Gg, Gg, Dd, Ds, Ds, Gg, Ds, Dd^Ftd, Cd^Edb, 1 Kdr^Edb, Cdr^Edb, Dd^Vdt, Dd^Ecf, Gs, Ds^Esd, Wwr, Wot, Xu, Wot, Wwr, Wwr, Dd^Esd, Ds^Esd, Gg, Dd^Ecf, Dd^Vdt, Cdr^Edb, 4 Kdr^Edb, Cd^Edb, Dd^Ftd, Ds, Gg, Gg, Gd^Fts, Gg, Gg, Gg, Gg, Gg, Gs, Gg, Ds, Dd, Dd, Gg, Gg, Gd^Fts, Gg, Gg, Gg, Ds, Wot, Wot, Wot
Wo, Wo, Wot, Ds, Gs, Gg, Gs^Ftp, Gg, Gs, Gg, Gg, Gg, Gg, Gg^Es, Md, Gg, Gg, Gg, Gg, Dd, Gg, Gg, Gg, Ds^Edp, Gg, Gg, Gg, Cdr^Edb, Gg, Dd^Es, Ds, Dd^Es, Ds^Esd, Wwrt, Wot, Xue, Xue, Wot, Wot, Dd^Ftd, Dd, Dd^Esd, Dd^Es, Dd^Esd, Gg, Cdr^Edb, Gg, Gs, Gg, Gg, Gg, Gg, Gg, Gg, Gs^Ft, Gd^Fts, Gg, Gg, Md, Gg, Gg, Gg, Gd, Gg, Gg, Gs, Gd^Fts, Ds, Wwr, Wot, Wot, Wot
Wo, Wo, Wot, Ds^Esd, Ds, Gd^Fts, Gs^Ftp, Gg, Gs^Vc, Gll, Gg, Gg, Gg, Gg, Gg, Gg, Gs, Gg, Gd^Fts, Gg, Gg, Gd, Gs^Ft, Gg, Gg, Gg, Gg, Gg, Gg, Gg^Esd, Ds^Es, Dd^Ftd, Wot, Wot, Xu, Xue, Wot, Wwrt, Wwrt, Ds^Esd, Dd^Esd, Dd^Ftd, Gg, Gg^Esd, Gg, Gg, Gg, Gg, Gg, Gg, Gg, Gg, Gg, Gg, Gg, Gg, Gs^Vc, Gg, Gs, Gg, Gd^Fts, Gg, Gg, Gs^Vc, Gg, Gs^Ftp, Gg, Ds, Dd^Ftd, Wot, Wot, Wot
Wo, Wo, Wot, Wot, Ds, Gg, Gg, Gg, Gg, Gs, Gg, Gs^Ft, Gg, Gg, Gg, Gg, Gs^Vc, Gs, Gs, Gg, Gg, Gg, Gg, Gs, Gg, Gs^Ftp, Gg, Gg, Dd^Ftd, Ds, Wot, Wot, Wot, Wot, Wot, Xu, Xu, Wot, Wot, Wot, Wot, Dd, Dd^Es, Gg, Gg, Gg, Gs^Ftp, Gg, Gg, Gg, Gg, Gs^Ft, Gg, Gg, Gg, Gg, Gg, Gg, Gg, Gg, Gg, Gg, Gs^Ft, Gg, Gg, Gs^Ftp, Gg, Gg, Ds^Esd, Wot, Wot, Wot
Wo, Wo, Wot, Wot, Ds^Esd, Dd^Ftd, Gg, Gg, Dd^Ftd, Gg, Gg, Gg, Gg, Dd^Ftd, Gg, Gg, Gg, Gg, Gg, Gg, Gs^Ft, Gg, Gg, Gg, Gg, Gg, Dd^Ftd, Ds^Edb, Wot, Wot, Wot, Wot, Wot, Wot, Xu, Xue, Wot, Wot, Wot, Wot, Wot, Wot, Wot, Dd^Ftd, Ds^Edb, Gg, Gg, Gg, Ds, Ds^Esd, Dd^Ftd, Gg, Ds, Ds, Ds, Gg, Gg, Gg, Gg^Es, Gg, Gg, Gg, Gg, Gg, Dd^Ftd, Gg, Gg, Ds, Wot, Wot, Wo, Wo
Wo, Wo, Wo, Wot, Wot, Ds, Ds^Esd, Ds, Ds^Esd, Gg, Ds, Gg, Ds^Esd, Ds, Ds, Gg, Ds^Esd, Gg, Ds^Esd, Ds, Ds^Esd, Ds, Ds, Gg, Dd^Ftd, Ds^Edt, Wot^Edt, Wot^Edt, Wot, Wot, Wot, Wot, Wot, Wot, Wwr, Xu, Xu, Wot, Wot, Wot, Wot, Wot, Wot, Wot^Edb, Wot^Edb, Dd^Ftd, Ds^Edt, Ds, Wot, Wot, Wot, Ds, Wot, Wot, Wot, Ds, Ds, Ds, Ds, Gg, Ds, Ds, Ds, Gg, Ds, Gg, Ds, Ds, Wot, Wot, Wo, Wo
Wo, Wo, Wo, Wo, Wo, Wot, Wot, Wot, Wot, Ds^Esd, Wot, Ds^Esd, Wot, Wot, Wot, Ds^Esd, Wot, Ds^Esd, Wot, Ds^Esd, Wot, Wot, Wot, Ds^Esd, Wot, Wot^Edb, Wot^Edb, Wot^Edt, Wo^Edt, Wot, Wot, Wot, Wwr, Wwr, Xu, Xu, Xue, Wwr, Wwr, Wot, Wot, Wot, Wot, Wot^Edt, Wot^Edt, Wot^Edt, Wot^Edt, Wot, Wo, Wot, Wot, Wot, Wo, Wo, Wo, Wot, Wot, Wot, Wot, Ds, Wot, Wot, Wot, Ds, Wot, Ds, Wot, Wot, Wo, Wo, Wo, Wo
Wo, Wo, Wo, Wo, Wo, Wo, Wot, Wot, Wot, Wot, Wot, Wot, Wot, Wo, Wot, Wot, Wot, Wot, Wot, Wot, Wot, Wo, Wot, Wot, Wot, Wot, Wot^Edt, Wo^Edb, Wo^Edt, Wo^Edt, Wwr, Wwr, Wwr, Xue, Xue, Xue, Xue, Xu, Wwrt, Wwr, Wwr, Wwr, Wwr, Wo^Edt, Wo, Wot^Edb, Wot, Wo, Wo, Wo, Wot, Wo, Wo, Wo, Wo, Wo, Wot, Wot, Wot, Wot, Wot, Wot, Wot, Wot, Wot, Wot, Wot, Wo, Wo, Wo, Wo, Wo
